 #####  
 #---## 
##-*-.##
#-$$*--#
#--*-.-#
##-@-###
 #####  