 ####  
 #--###
 #-*$-#
 #--#-#
##-**-#
#---#@#
#--**-#
#---#-#
##-*.-#
 #--###
 ####  