######  
#----#  
#-##$###
#-.-*--#
##--*-+#
 #--$--#
 #-#*###
 #---#  
 #####  