######### 
#-.@.$.-# 
#-#-$---# 
#-##$#### 
#---$--###
###-.----#
  ###----#
    ##---#
     #####