-#####--
-#---##-
##-*-.##
#-$$*--#
#--*-.-#
##-@-###
-#####--