    #####
#####--@#
#--##$$-#
#-----$-#
#---#####
###-#    
 #--###  
 #-...#  
 ######  