 ####  
##--###
#..@$-#
#..-#-#
###$#-#
#---#-#
#-$---#
#--$-##
###--# 
  #### 