####### 
#..##@##
#.$-$$-#
#*-$---#
#.--####
#####   