--###---
--#.#---
--#-####
###$$-.#
#.$@-###
####$#--
---#.#--
---###--