----#####
#####--@#
#--##$$-#
#-----$-#
#---#####
###-#----
-#--###--
-#-...#--
-######--