-####--
##--###
#..@$-#
#..-#-#
###$#-#
#---#-#
#-$---#
#--$-##
###--#-
--####-