#######-
#..##@##
#.$-$$-#
#*-$---#
#.--####
#####---